C 0,100,255
F 100,100,100

NO ./assets/wall/bluestone.png
EA ./assets/wall/colorstone.png
SO ./assets/wall/redbrick.png
WE ./assets/wall/wood.png

111111111111111111111111
1                     B1
1         K            1
1                      1
1     11111111111      1
1     1B   C   B1      1
1     1 K     K 1      1
1     1         1      1
1     11111 11111      1
1                      1
1                      1
1                      1
1                      1
1                      1
1B                     1
1BB                    1
111111111              1
1B1     1              1
1 K K K 1              1
1 1  C  1              1
1 1     1           N  1
1 1111111              1
1                      1
111111111111111111111111
