C 50,50,50
F 100,100,100

NO ./assets/wall/bluestone.png
EA ./assets/wall/colorstone.png
SO ./assets/wall/redbrick.png
WE ./assets/wall/wood.png

1111111111111111111111111111111111111111111111111111111111111111111111111111111111111111111111
1L                    B1           p                         1        1        1    1        1
1         Kl                l      l       l        l      l D  KC K  1  &TC   D    D  KCK   1
1                      1V      A      A                      1        1 ]      1    1        1
1     11111111111      11111111111   111111111111111111111   1        1111111111    1111111111
1     1B f $ f B1      1         1   1         17        1   D  KC K  1                      1
1     14Kl T lK 1      1s K l K  D   1   9&9   1  K l K  D l 1       91  K K K K    K K K K  1
1     13  8 8  21      1         1   1    C    17        1   1111111111   K K K      K K K   1
1     11111 11111      11111111111   D  K T K  11111111111   1        1    K K        K K    1
1        A   A         1         1   1   K K   1         1   D  Kl K  1     K          K     1
1P                     1s K l K  D   1         1  K l K  D l 1        1                      1
1                      1         1   11111111111         1   1111111111                      1
1     l         l      11111111111   1         11111111111   1        1                      1
1                      1         1   D  K l K  1         1   D  Kl K  1                      1
1B                     1s K l K  D   1         1  K l K  D l 1        1                      1
1BB9                   1         1   11111111111         1   1111111111                      1
111111111              11111111111   1         11111111111   1        1                      1
1B1     1              1         1   D  K l K  1         1   D   l$   1                      1
1 K K K 1              1   K K   1   1         1   KCK   D l 1        1                      1
1 1  l  1       l      1  K T K  D   11111111111  K T K  1   1111111111                      1
1 1  #  1P          N  1   KCK   1   1         1   KCK   1            1                      1
1 1111111              1    *    1   D  K l$K  1    *    1Bl   l   l                        b1
1                     b1[        1BBB1         14   9    1BB         B1                    bb1
1111111111111111111111111111111111111111111111111111111111111111111111111111111111111111111111
