C 50,50,50
F 100,100,100

NO ./assets/wall/bluestone.png
EA ./assets/wall/colorstone.png
SO ./assets/wall/redbrick.png
WE ./assets/wall/wood.png

11111
1   1
11D11
1   1
1 N 1
1   1
11111
