C 0,100,255
F 100,100,100

NO ./assets/wall/bluestone.png
EA ./assets/wall/colorstone.png
SO ./assets/wall/redbrick.png
WE ./assets/wall/wood.png

11111111111111
1BbLAPpVfTslC1
1$#*&987[]3421
1            1
1      N     1
1            1
11111111111111
